****S***
**   ***
*      *
***    *
*****  *
****** *
E      *
********