S ******************
*  *       *       *
*  * ***   * ***   *
*  * * *   * * *** *
*  * * *   * *     *
*  *   *   * *  ** *
*  ***** *** **    *
*             **** *
* ***********  * * *
* *         ****   *
* * ****         ***
* * *  ***       * *
* * *  *****   * * *
* * *  **  *   * * *
* ***  *   *   *** *
*      *   **      *
*      *    ***    *
*      *           *
*      *            
*******************E
