********************
*            *     *
*            *     *
*            *     *
*     *      *  E  *
*     *      *     *
*     *      *     *
*     *      *     *
*     *      *     *
*     *      *     *
*  S  *            *
*     *            *
*     *            *
********************