**********************S*****************
*********************       ***** **   *
*              ********    **          *
*                            *         *
*************       *            *******
********            ***********      ***
E               ******              ****
****************************************